#..#..##....##..#...#.#....##...#........##...#...#..#.#.....#...#......#...........##........#.
.........#.......#....##..##.....#.#.....#...##......##....###...##.##...#.##.#....#......#.#.#.
#.....#.#....#.#...#..#.#...........#......#...##.##.....##.#....#.#.#...#...#...#.#..#........#
#...#....###...#...#.##....#.....#..........#...#..##.............##.#.###.#.......#............
........####....#.#.....#.........#.......#........##.......##..#..#.#...#...#...#..#.#..###....
....#..###...........#.#......#.....#...#.#.#.#......#.....#..##.##......##.....#.#.........#...
......##....#.......#.....#.##.#......#.#............#..#..#.#..#.##...........##...##......#...
....#....#..#........##..........##.#.#..#........#.............#.#.#..#....#.#.#..#.#..#..#.##.
......###.#.....#.#.#....##...#.#...#.......#......#.#...#............#...#.....###..#....#..#..
.....##.#..................#.#..#....##.....#...#.#......##.#...##.###...#.....#..#............#
.##..##...#....#.......##.#.........#....##.......#.###.#.#.......####..####....#.....#.....#...
.#..#...#..#...##.#.#..#....#.....#....#...#.......................#..##..#....#.#...#.........#
.........#..#..#..#.......#...........#.....#.#........#..#......#..#...#..#...##....##....####.
..#...................#...#.#........##.......#...#.#.#..###.....#.#....#.....#.#...#..#....#...
..#...#...#....#.....#........#..#.......#...#........##.##..#..#.##.#.#..#.#....#.....#.#.#..#.
#..#.......#....#.#.......#.................#....#...##..###.##.#..##....###.....##....##......#
...#..#..#........##.#.#...##.#....#.##.##......##...#.....##......#.....###....#..#............
...#......#....#...#......#.#...#.#..#.#.....#.#......#.##....#....#......#.#....#..#...........
.###........#.......#..#....#.......##.....##.#....#..#.#..#....###.#.##....#.#.##..........#..#
.#.#...#...#.#....#.......##..##....#.#.#....##....#...##.#...#......##...#.....#.#....#........
..#.#......#....#.#.#..#..#...#.......##..#.#...........#.#.#....#.#.#...##......###..#......#..
#......##.##......................#.#.....#..........#.#...#...#.#..##...##...................#.
.#....#....#.......#...#........##...#....##.#.###..............#..#...#.#.#...##.#.##.#....###.
....##...#..#..#........#...#..##.##..##..##.#.#....#..........#.####..#.........#..#.#....#..#.
.###...........#....###........##........###.#......####.#.#.#.#..#.#...#.......#....#.......#..
#.###.........#..........##.#.#..#...#..###..#.#....#####.#.....................#..........##.#.
....##.....###....#...#....#..#.##..#...#..####...#....#..##.....#...#....#.....#......#.....##.
#....#...###..................##...#...#....#.....#....#...#.###...###..#.#..#.#........#...#...
...........#.#..............#.#.##...##.....#.......#.#...##.#.....#..##.........#..#.#......#..
....#....#..###....#.##.##.#....#.#........#.#....#..#..#.....##......#.#...####.####..#.#...#.#
.#.###.#...........#...........###.##.#...#............#.#.##....#..#...#....#..#..#.....##.....
..###........#...#...#...#....#..#...##..###.#..#....#..#.###..#..####.#.##.........#...#..#...#
#..###.....##............#.........#.##....#..#....#.........#.#.#..#...........#..#..##..#....#
..##...#.#.#.#.###.....#..........#...##...#..............##...........#......#.#...#.##...###..
..........##.........#.....#.#.#.#.....##..#.#.....#.#..#...#..##.#.#.#.#...#.......##.....####.
....#.....#.#....#.#.........#####.....##.##........###.....#..##.#.##.#.....#...#......#...#...
...###.#.......#.#......#...#...#.........#....#....#.....###..###........#..##..#..#..........#
........#.....#.#...#.#....#.....##..#.##.#..............###...#.#.......#.#...#...#..#...#.....
..........#.##....#..#..#.......#...###.##.#....###...#........##........#....###....#.##..##...
.#.#.#....##....######..#..........#..#.....#.#..#..#.#.....#...#.#....#.............#.#....#.#.
.#........###.....#..##.......#..#.....#.....#.........#...#....###.#...#..#...#...###.##...#...
...##........##..........#.##...#...#......##.#.....#..........##.....#....###.##...##...#.##...
.#...#.....#..#.....##.#.##....#..........#.#...#..........#....#...#...#...#.#.###.#.#.....#...
.....#.....##...........#..#..#.....##.#.#..#..#...#......##.....##.##...#...#....#..##.....###.
...#....#.#..#..##.#......#..#.#.#....#.......#..#.....#....#.#.#..##.#..#......#.#..#...#......
..##....#.....#........#..#....#.#...##..#..........###..........#.....#..........#...##....#...
...##..#..#........#.#.......#.........#..#.#....#..#........#...#....#.......#.##...#.#.....#..
.#..#...##..#.....#.#...##.##..#.##....#.#.#.#.#.....#..#..#.#.##.......#.#.#....##.##....##..#.
.#.....#.#.....#..#.#..#.#...#.....#........#.....#........#..###...#......#.....#...##.....#.#.
.#.#..#.#.#...#.##.#......#....#.....#.#..#..#..#.##...##..#.....##...##.#......#..#.....#......
.#..#.....##.........#.#.....#...##...#.#...#..#......#.....#.#....#.#...#...#.....###..........
...#.#.##..#.#.#......#.......#............#...##...###....##.........####..#.###..#..#.....#..#
.#.#...........##.###......#..#........#..##..#....##........##..#.......###...#.....#........#.
...##...#.......###......#.........##.##......#..#.....#.......###.....#.##...#...#.##..........
##.#.##...#...#.##..##.##........#....#..#.##..#.#.......###.#.........#..#.......#.#.#.#.......
#.###..#.#..##.....##.#.#..........#...#...##.....#..###...#.....###.##.##.#........#..........#
#...#.#...#.........#.#....#...#.....#..#...#.###.#..##..#..#.#..#....#......#..........#.......
...##......#.#......##..............#.#.....##......#..#.....#.#..##.#..#.#.......##..#.......#.
##.#..#.....##..#..#.#......#.##....#.....#..#.....#.#.....#.#.##..........#.....#...#....#.....
....###.#..#.#...#..#...#..#.#..#.....##..#.....#..#...#.##.#.##..#.##.#.##..#..........#.......
..##.#..#....#.#.#...###.......#...##.##.....#..##.#...#.#...........#.#..#..#.......#.###..#.#.
..##.#..#.........###.#..#...#.......#.#....#..#..#...#...##.#..#..........##.#....#...##.......
...####.###.#..#...##.#...##.#..........#...#......#........#......#...#.....#........#...#..#.#
#.##..##.##..#.#.#.#.###..#.#..#..#.........##...#.........#...###...#...#...#...#....#.#.#.....
#......#.###....#.#......#.##.....#.....#.........#......##.....#..........#...#.......#....#.##
.#......................#.#.##.......#..##.............##..#..#...#..#....##...#.#..#..#........
.#.#.....##.......#.##.......#.###.....#....##......#.....##.#.##...#.#.#.#........##.....##.#..
.#...#..#....#..##.##.#.....#...##.#..##....#..#......#....#.#....#...#..#.#.##.#...#........#..
...#.####...##.....##.....#..#..#.......#.###.....#.....#.###..#.....................#........#.
..##..........#.#...###..#...#.##.##.#......##...#..#...#......#.#.............##.....#....#....
..##.#..#....##.#.......##..#...#..#.##.....#............#.#.#...#.......#.##.##..#.##..#.....#.
...###...#....#..#.........##....#......#...###..##.........#...##..#.....#.#.....#..##.......##
.....#.###..#.##.##.##.....#.#.........#.....#....#........#..#.#...#..#............##.....#....
.#.....####.......###........##.....#..#..#.#...#..#.#..#..#..........#..#........#.#..#........
##..#.#...#.#.........#..##.............#....#...##.#..#.#..#....#....#.###..#....####....#.....
#..##.......#..#.#...#.......#......#...#.###.#.#...##......#..#.........#......#.....#........#
.#.##..###.##.#....##.....###.#.###.#.......#.#.........#...............#......#...#......#.....
....#...#.##.##.............#.###.#....###..#.#.#...#.#.....#..##..##........#...#...#.#.#......
.##...#..#.#...#..#...##..#..##..#..#..#...#...#........#..##.#...#......#....#..#..##..#.......
#........#..#......###.#.#..##....#..#.#.#.#..##...........#.......#...#...#....#...#.####.#..#.
#.###.....##...#..###...#.....#.................##.#.....#..#.......#........#....#..#.##....#..
.#.#...##...#..#.#......#....#.......#.....#.##..#...............##..###.#.......##...#......###
...#....#....##.#.....#.....##......#....#...#.##...#...##........#.##.#.#...#...##.....#..#.#..
.#..#.##..#...#.#.##...##.....##.....#........#........#....#..................##....#.....###..
....#.#..##....##.......##..#####.....##.........#.#.......##...#.#..##.#...#...#..#####.....##.
......#..####..........#..#...#..##...............##........#.....#.........#....#.....#.##....#
#...#.....#.....#..#.#....#..........##.#...#....#...#..##.#.#..###..#......#.......#...#.......
..###...##.#...#.#.#.#.................#...#..........#....#.#....#.##...#.#.#..#....#..#.#.#.#.
#..#......##..#.#.....................##.#..#..#...#...#.....##..#.#.....#...........#.#.#......
......#...#.......####.....#..#...#..#...#.#.#......#...##.##...#.....#..#............#.........
.........##.......#......#..#..###...#...#......##..##.......#......##..#.....#...####..##......
.#..#..##....#..#.#...#.........#....#...#......#......#.....#..##..#..........#..#...#..#.##...
..#..###.#..........#..#.###..#.#.#.........###..##....#..#.##..##.#....#..#.#.....##....#....#.
#.....#.#..#..#...##..............#............#....##..#....#.....#.#.....#..#........#.#..#.#.
..#.#....#........##.......#...............#......#...###.#.#....##......#....##...#.#..........
#.#.#....#.....#.#....#..#..#.....#.#.......#.....#....##.##.#...#.##.....#.....#...........#.##
