###........#...##....#.......##.###.#####....##.####...###.###.#.##.....#######...#.#.##....##..###..####....##.#..##.##
##..#..##......##..###...#.#.##...##.....#.......##.##...#.....#..#.###.....#..##.#......###.............##..##......#.#
.........##.#.........#....####..##....##.#.#.......#...##........##......###.....##.##..##.#.##.#.##...#........#.#.#.#
##.....#.###....#.#.....#..#.###.......##....#........#...####.##....##.##.#......#.#.#.....#...#.....#.#..#.##.......#.
##...#...##.###...###...#.##.##...#....##.#............#.....#..##.................##.#.#####.#.........#...............
...........####......#.#.......#...........#.........#.....##...##.........##....#..#.#.....#...#.....#..#.#.##.###.....
.....#..#..##.............#.#........#.......#...###.#.#.#........#..##...#..####.##.....##.##.....###.#.....##....#....
.......##......#...##....#.......#.##.#........#...#.......##.....#..###..#.#..###.##.............####...##........#...#
.....#...##.#..#..........##..............##.#.#.##.#......##..#...............###.#.#..###....#.#.###..#.#..###..#.##..
...#.##.#########.#..#..#.##...###.#...###.##...#....##..#.........#.##.##.##..###..#..#...#.##.#####..##.###..##..#.#..
...#.##.#########.#..#..#.##...###.#...###.##...#....##..#.........#.##.##.##..###..#..#...#.##.#####..##.###..##..#.#..
.......##..#.#.......#.#.#......##...#...#...#...##....#...##...#.#..##.#..............#.##..#.......###..#......#..#...
......##...#.......##.............#.#....#....##.##....#.....#.#........##.#.....##.###.....#.....###..#..............#.
#.##..##.##..#....#.........#..#.#...........#...##.##.........#.###.###.#.........####....####....###.....#.##....#....
..#..#.....#..#...#..#.#.#..#......#...##..#....#.....#....##..................##...#..##....#....#...#...#..##.......##
#........##.#..#..###..#.........#.....##......#.##....#.#.##.......#....#........#..#...###..#...#..#....##......####..
#..#.....##................#.##..#.#...##.....##.........#.....#.#.#....###.......#.#....###.....#...#...#..#......#...#
#..#...#.....#....#.......#..........#....#......##.#...#..##......##...##..#....#.##.#.###..#.#......#.....###.#.#..#.#
##..#....##...#......#.#.........#...............##....#...##.#...##....###.##...#..##...##.###.......##....#..#......#.
..#.#...#..####.###...#.###.###..###.....##..######.#....##...#.###..##.#..#.....#....#.####..####.###.#.#..#####..#....
..#.#...#..####.###...#.###.###..###.....##..######.#....##...#.###..##.#..#.....#....#.####..####.###.#.#..#####..#....
#...#..#....#..........##.#.###...##.#......#.##.####......####...#..##...##...##...#....##.###....###..#....##........#
#...#........#....#.....#........#.#.....#.#..#.###.....#.#........#.####....#.##...#........#.#...##.#..#.............#
#.###....##....#...##....#..#......#...##....##.......##.#.##...#..#.###..#......###.#.##......#.#.####......##....#..##
#.#.#...#.....#.#......#.........##..####....#.#.###....##.##...#...#..#.#...#........##.....#.....###.#....###.........
...#.#........#....###.#.#..###..#...#.........####..#.#.............###.#.#......#.#.#.....##.....##.###..#.##.....#...
##......####.##..............##........##..#.#.......#............#.###...#...###.#..##..##.##.......................#..
#.#....#.##...#.........#...#............##...#......##.#.#..##......##........###..#...###.#.#...####.#.##.###....###.#
.....##..##.#..#..###........###...#..#..#.##..##....##.#.#......#...##.......#...####..#..........##.#..#.#.##...#..#.#
.#..#.######..#####...#...#.#######.#.#..#...##.#..######..###..#...#..#####..#..###..#.#...###.#.#......#.#.##.#.##.#..
.#..#.######..#####...#...#.#######.#.#..#...##.#..######..###..#...#..#####..#..###..#.#...###.#.#......#.#.##.#.##.#..
#.###.............#......###..........####.......##.###.#..##....####...#.#.#.###..#.#...###.........#....#.........#...
##.###...........#.##........##.##.#.#.##.#...#..#####..#.###....#######.#.....##..................###............##.#.#
#....##..##...###..##..#...#......#..#.####..#.....#..####.....#....#....##.......#...#......#.....###......###.....##..
.#....#..##.###....##........##......##.....#...#......#.......#....###...#.###.....###..###.#..#.#..........###...#....
.........##...#.#............##....#.#.####...##.##....#...##....#.#.....##.#.......#..##..........##.#..#.#........#...
.....#......#..###.##...#.##.####.#....###.#.....##...#.#..##..#..#....#.....##........#...#...######.####..###.#...#.##
..#.###.#...............#.............#####.##.#.##..#.....##.......#...#.##......#..#...###....#....#..#.......##......
#..###...##.....#.....#...#..##.#....#....#...##.##.###.#..###....#..###.###..#....####.#...##...........#...###..#...##
#..###.########.#####..#.#...########.###.#.#####..##..##..####..#.#.###..#.##...###########...#..#..#.#.##.####..#.....
#..###.########.#####..#.#...########.###.#.#####..##..##..####..#.#.###..#.##...###########...#..#..#.#.##.####..#.....
##..###.......##...##...........#......##...#.##.##...#..#.##...#....##.....#.#...#..#...##........###..#..##....#....#.
#..##...###.#.#.#.#####.....###............#...####...#..............##..##.............#........#.###...#.##.....###...
#........##..##....##.....#.......#.#.###.#.....#..#..#.#..##...#.#....#...#..####.#.#.#...#...#.........##..##...####..
.....#.......#.#......#.#...........###..##.....####.##..........###.......#..#..#.#.##.###.....#..##.#........#...#...#
#...###.#.........###.#......###...#...###...........#....#......#...##..###..#..##..........#..##.##.#..#...##.......##
.........###.....#...#...#.#......#.......##..#.####.#..................###...#...#.........#.#...###...#..#.##..#.....#
.............#.##......#..#....#.......###...###.####.#....#####...#.##.......####..........#....#####....#.#..#..##....
..#.#.#......##....########....#.......##...#..#.##....#.#.##.#..#.#.......#.....#.#....#..........##.....#.#......#.#.#
#...#.#.#...#.#..#.###...#...##.##.#.#.....###.#...##.###.#...#.#.#.#....#.#..###.##.#.####.##.###....#####.#....###.#.#
#...#.#.#...#.#..#.###...#...##.##.#.#.....###.#...##.###.#...#.#.#.#....#.#..###.##.#.####.##.###....#####.#....###.#.#
..#......##..###...##..#..##.........#....#.....###.....#...........###...#....#####.#.....#..#...#.....###.#..#...#....
#...##...##.....##...........##.#.##...###...#...##...##.#.##....#............#..#.....#.##...###.####...##.....#.##....
..#...#..##...#..#.##....##.###.##....###............#.#...###.......##...#....###...#.....#...#.#...###.#.#.......#...#
#.....#.......##...##........###..#..#.##....##.###.#..#..###...#....##..##....##.##.##..##.#...#......#..##.......###..
#...#......#.#..#..####.#....##..#..#.#...#....#.........#.##.#.....###....#.#...#..##.#....#......###.#..#..##.#......#
#..##....###.....#.##.......###..#....###.#...##....#......##....###.##........##.#.....###............#...####....#...#
....##..#....#.....##...#.#..##.....#..##.......#....#.#...##.#..#..........#.....#....#.........#...##...#.#.......#..#
..#..#.....##..#.......#.#.....##.##..###.##....#...#.#.#.###.....#..###..#.#.####.......###.#.#......##.##..##..##..#..
#.##.#.#.##.###..#.####.#..##..#...##..###...##..##....#.#.#####..#.###.#.#..#.##.#......###..##.#.####.....#..##.##..##
#.##.#.#.##.###..#.####.#..##..#...##..###...##..##....#.#.#####..#.###.#.#..#.##.#......###..##.#.####.....#..##.##..##
..#.....#...#.....###..#.#..###.#...#..##...#....##....#...##..#.....##...#..#####...#...##...#....##.#...##.##....#.#..
..#.#..#...#.#...#...##.#........#....###.....#.#....#..#..###.##...#..#..#....##.##...####.#......###..#....##.#.......
#.#..#.......##...........#.#.......#.....##...#...#...#..#........#.......#.#......#.#..##.#...#..##...###.............
#...#.#.#..#..#.#.###......#.##......#.##........##...#...#..#...###.##...##...##......######..#.##..#..#..#.......#..#.
#.#.#.............#..#.###...##...#..#.##.......###..##..#.##...##...##.....##....#......##.###...#.......#..........#..
....##...###.......#####........#......##...##.##........#.##.#.....###.......#####.....#...##...#.....#.##............#
###.#.##.##..#...#...##..##.####..........#....#....#.##..###.#.........###.#...........#....#.....##..#.#.#...#........
##.###..###.#..##.......##.#...#............#...###...##.......#..#####...#.......###.##.####.#..........#............##
.##..#.....##...##########.#...#..###.#...#.#.#......#.....##.#.#.##....#....#.####.#..#...###.#..###.##...######...##..
.##..#.....##...##########.#...#..###.#...#.#.#......#.....##.#.#.##....#....#.####.#..#...###.#..###.##...######...##..
.#...#.#.##..#.....##....#.#.##...#...###.....#....#...#.#####.#..##....#..#.#....#....#........#..##........###........
#...##........#.#..##....##..##........##....#.#.......##........#..#.......#.###..##.#..###.#.........##..#.##......#..
.##.#..#.......##..###..#.#........#.##......#...##..#..#..##...#.#..##...#.#.####............#.......#...#..##..#.....#
.....###.###..#.#.....#..#.....#..#.#..###.....##....#.......#..#...#...##.#.####..#.##.###.##..#..##..........#.......#
#..##.#..###....#.#...#...###.........#.....##.####.....#..####.#...#...#......##.....#.###..#..#..##.....#.#..##..#.#..
#..##.#....#.......##..###.#....#...#..##.....#.###....#..###..#...#.##..##.#....#.......##...##.#.##...#...#..#........
#...####...###.#..#.....##.#.##..##.#..##..........#...#...##...#..........#...##...#...#.......#..........#.##..#..#.##
.#.##..##...##..#.#...#.#.#####..#.#..#....#.....##....##.....#......##...#...#..##...#..##.#...#..##.#....#.###.#.....#
#.....#..##.##.##.####.....#.##..#...#.###.#####.....##..####...#...#..##...#......#..###...##.....##...#.#.###..#.#..#.
#.....#..##.##.##.####.....#.##..#...#.###.#####.....##..####...#...#..##...#......#..###...##.....##...#.#.###..#.#..#.
##......###.###......#.#.....##.#.##...##..#.......#.......##..#........##.....###.......##...#...#.........###....#.###
..#..........................###.#.##.........#....##......##.......#..#..#..#.....#..#..##..##...###.#..#..#..........#
#.#.#....##.##.....##..#.##.........#.#..##.....#......##........#...##..##.#.####...#.#.###.#..........##.......##.#..#
..#...#..###....#....##.##.#.##....#.....##.#..####....#..#........#......#.#..##..#...#....#.#.##.###...#..........#..#
....#.######...##..##...##...##..#..#..###.......###.###...##..#.......#.###..###........##........##.....#..##......#.#
#..##....##......#...#...###.##.#...#.#..#.##.#........##.....#..#...###......#...#...............#..#.....#......#....#
#..##.#....#....##...#.......####..#...###..#.##.##....#...##...........#.#.#..##.#.........#.##.####..#.##..###.....#.#
....###.....#....#....#...........##...##.#........#...###.##.##...........#.....##..#.......#.#...##..#..##.##......##.
####.#.#....###..#.......#..#....#....###...###..##...#####.........######.##.###.#.#.#.....#.##.##..#..#.###..###...###
####.#.#....###..#.......#..#....#....###...###..##...#####.........######.##.###.#.#.#.....#.##.##..#..#.###..###...###
......#.#..##..#.####.##.##..##...#.#..##.......###.....#......#.....##...#..#.###...#..#..........##....##..##...#.....
..#.....######.........###..........##.##....#..###..#.#...###..#.#....#..#....##......#.##.#......##..#.#..#..........#
.##..#.#.....#.#...##......#....##.....##........###....#..##.##.#..###.#..#......#....#...###..#......####..##..#......
##..##.........#..#...#...#.........#..##....#...###.###.#...#...##..##....#..#..........##.#........#.....#.##.......#.
#.#.##..#####.##.#.##...##.......###.#...###.#.........#.#.##........###.......##........###......###...#........#.....#
#....#...###.##.##.##........##....#.#####.#....#####..#.#.###...#.#.......#..#..#..##..........#..##.#...#.###.#.......
..##...#.##.#.#...###..#...##....#..##....#..#..###...#...#............#..##.#.....#.....##.#....#....#..##....#.......#
##.......##.#..#...##...###.#...#..##..##..#..#.#...#.#..##..........##...#....##...#...###...#....###...#.######.#..#.#
#...#..####.####..#..#..##..........#.###.##...#.#######..###..#.#.#...##.###.....#......######....##.##.........#.###..
#...#..####.####..#..#..##..........#.###.##...#.#######..###..#.#.#...##.###.....#......######....##.##.........#.###..
##.###.......##...#....###.....#.....#.......................##.#.......#..#.........#...##.....#......#..#.####....#...
#.#.#...####...#..#...#......###....#..##.....#.......#.##....#...................##..###...#......##.##...#.##.....####
....#......#....##.###.....#.##....##........#...##.#...#.#..#...#...####......##..#.##.###.#...#..##.##.....###..#.#...
#.#..#.####..#...#...#.##...#..#.....##.......#..........#.##.......###....#...##.................####....#..##...###...
#....#.#.##.##....####.......####..#######.....####........##.#.#....##...##.....#.#..##.###...#.....#..#####.......##..
#......#.##.####............#....#...#....##.....##............##....##....#...##..#.....##....#......#.....#...##....##
.#...#...##..#.....###..#.#......#............##...#...#...##.#...#..####.#.#..#####..#..##....#.........#...###.......#
#..###.....##.#...###.#.#.#............##.......###...#............#.##...#.#..##..#.##.....#.#.#..###....#....#.#.#.#..
...##...###.#.#.#..##..##..#.##..##.#..##.#...#.#####.#..#.##..####.....#..##.####.##.##.....#...#....#..#.#.###..#.##.#
...##...###.#.#.#..##..##..#.##..##.#..##.#...#.#####.#..#.##..####.....#..##.####.##.##.....#...#....#..#.#.###..#.##.#
##..#....##..##..#...#.......##........##......##...#..#..###...#...#.......##....#.#....##.#.............#.###.#.......
#......#.....#.........####.......#..#.....#..#.....#.#.#..##....#...####.##...###.....#.##.#......##......#............
............##.........#.....##.#..#..#####...#.....#........##..##.........#........##..###.....#.##..####..####.......
#.#..#..####....#....#.#...#.##..........#....#.....#......###......#.......#....##..#...##.......#....#...#....#.##...#
...#..#####.#............#..###.###..#...#.#.....##....###.##.##....#....#.##....##.#....###..#.#..##...##......#....#..
##.....#...#..#..#.##..##..............##..#..............#......##..###....#..##...#.#.......#..#..........#...#..#.#.#
#..#.#...##.#......##..##....##...#..............##...#....##..#...##..#.#.#...##.##.....##.#....####...#.#..##........#
##.#.#......#.....###.#....#.##.#..#...##..#.#.........#.......#....#..#.##.#.....#.##.......#.....###.......##....#.##.
#...####.....##.##.##.#.####...###.........##.###..#..#.#.####....########..###..#..#...#..##..###....#.#.#.###.##..#..#
